Size Of Maze: 8*8
-------------------------
iteration: 1

||  -1 : ←  ||  -1 : →  ||  -1 : →  ||  -1 : →  ||  -1 : →  ||  -1 : →  ||  -1 : →  ||  -1 : →  || 
||  -1 : ←  ||  -1 : →  ||  -1 : →  ||  -1 : →  ||  -1 : →  ||  -1 : →  ||  -1 : →  ||  -1 : →  || 
||  -1 : ←  ||  -1 : →  ||  -1 : →  ||  -1 : →  ||  -1 : →  ||  -1 : →  ||  -1 : →  ||  -1 : →  || 
||  -1 : ←  ||  -1 : →  ||  -1 : →  ||  -1 : →  ||  -1 : →  ||  -1 : →  ||  -1 : →  ||  -1 : →  || 
||  -1 : ←  ||  -1 : →  ||  -1 : →  ||  -1 : →  ||  -1 : →  ||  -1 : →  ||  -1 : →  ||  -1 : →  || 
||  -1 : ←  ||  -1 : →  ||  -1 : →  ||  -1 : →  ||  -1 : →  ||  -1 : →  ||  -1 : →  ||  -1 : →  || 
||  -1 : ←  ||  -1 : →  ||  -1 : →  ||  -1 : →  ||  -1 : →  ||  -1 : →  ||  -1 : →  ||  -1 : →  || 
||  -1 : ←  ||  -1 : →  ||  -1 : →  ||  -1 : →  ||  -1 : →  ||  -1 : →  ||  -1 : →  ||  -1 : →  || 
-------------------------
iteration: 2

||  -2 : ←  ||  -2 : →  ||  -2 : →  ||  -2 : →  ||  -2 : →  ||  -2 : →  ||  -2 : →  ||  -2 : →  || 
||  -2 : ←  ||  -2 : →  ||  -2 : →  ||  -2 : →  ||  -2 : →  ||  -2 : →  ||  -2 : →  ||  -2 : →  || 
||  -2 : ←  ||  -2 : →  ||  -2 : →  ||  -2 : →  ||  -2 : →  ||  -2 : →  ||  -2 : →  ||  -2 : →  || 
||  -2 : ←  ||  -2 : →  ||  -2 : →  ||  -2 : →  ||  -2 : →  ||  -2 : →  ||  -2 : →  ||  -2 : →  || 
||  -2 : ←  ||  -2 : →  ||  -2 : →  ||  -2 : →  ||  -2 : →  ||  -2 : →  ||  -2 : →  ||  -2 : →  || 
||  -2 : ←  ||  -2 : →  ||  -2 : →  ||  -2 : →  ||  -2 : →  ||  -2 : →  ||  -2 : →  ||  -2 : →  || 
||  -2 : ←  ||  -2 : →  ||  -2 : →  ||  -2 : →  ||  -2 : →  ||  -2 : →  ||  -2 : →  ||  -2 : →  || 
||  -2 : ←  ||  -2 : →  ||  -2 : →  ||  -2 : →  ||  -2 : →  ||  -2 : →  ||  -2 : →  ||  -2 : →  || 
-------------------------
iteration: 3

||  -3 : ←  ||  -3 : →  ||  -3 : →  ||  -3 : →  ||  -3 : →  ||  -3 : →  ||  -3 : →  ||  -2 : ↓  || 
||  -3 : ←  ||  -3 : →  ||  -3 : →  ||  -3 : →  ||  -3 : →  ||  -3 : →  ||  -3 : →  ||  -2 : ↓  || 
||  -3 : ←  ||  -3 : →  ||  -3 : →  ||  -3 : →  ||  -3 : →  ||  -3 : →  ||  -3 : →  ||  -2 : ↓  || 
||  -3 : ←  ||  -3 : →  ||  -3 : →  ||  -3 : →  ||  -3 : →  ||  -3 : →  ||  -3 : →  ||  -2 : ↓  || 
||  -3 : ←  ||  -3 : →  ||  -3 : →  ||  -3 : →  ||  -3 : →  ||  -3 : →  ||  -3 : →  ||  -2 : ↓  || 
||  -3 : ←  ||  -3 : →  ||  -3 : →  ||  -3 : →  ||  -3 : →  ||  -3 : →  ||  -3 : →  ||  -2 : ↓  || 
||  -3 : ←  ||  -3 : →  ||  -3 : →  ||  -3 : →  ||  -3 : →  ||  -3 : →  ||  -3 : →  ||  -2 : ↓  || 
||  -3 : ←  ||  -3 : →  ||  -3 : →  ||  -3 : →  ||  -3 : →  ||  -3 : →  ||  -3 : →  ||  -2 : ↓  || 
-------------------------
iteration: 4

||  -4 : ←  ||  -4 : →  ||  -4 : →  ||  -4 : →  ||  -4 : →  ||  -4 : →  ||  -3 : →  ||  -2 : ↓  || 
||  -4 : ←  ||  -4 : →  ||  -4 : →  ||  -4 : →  ||  -4 : →  ||  -4 : →  ||  -3 : →  ||  -2 : ↓  || 
||  -4 : ←  ||  -4 : →  ||  -4 : →  ||  -4 : →  ||  -4 : →  ||  -4 : →  ||  -3 : →  ||  -2 : ↓  || 
||  -4 : ←  ||  -4 : →  ||  -4 : →  ||  -4 : →  ||  -4 : →  ||  -4 : →  ||  -3 : →  ||  -2 : ↓  || 
||  -4 : ←  ||  -4 : →  ||  -4 : →  ||  -4 : →  ||  -4 : →  ||  -4 : →  ||  -3 : →  ||  -2 : ↓  || 
||  -4 : ←  ||  -4 : →  ||  -4 : →  ||  -4 : →  ||  -4 : →  ||  -4 : →  ||  -3 : →  ||  -2 : ↓  || 
||  -4 : ←  ||  -4 : →  ||  -4 : →  ||  -4 : →  ||  -4 : →  ||  -4 : →  ||  -3 : →  ||  -2 : ↓  || 
||  -4 : ←  ||  -4 : →  ||  -4 : →  ||  -4 : →  ||  -4 : →  ||  -4 : →  ||  -3 : →  ||  -2 : ↓  || 
-------------------------
iteration: 5

||  -5 : ←  ||  -5 : →  ||  -5 : →  ||  -5 : →  ||  -5 : →  ||  -4 : →  ||  -3 : →  ||  -2 : ↓  || 
||  -5 : ←  ||  -5 : →  ||  -5 : →  ||  -5 : →  ||  -5 : →  ||  -4 : →  ||  -3 : →  ||  -2 : ↓  || 
||  -5 : ←  ||  -5 : →  ||  -5 : →  ||  -5 : →  ||  -5 : →  ||  -4 : →  ||  -3 : →  ||  -2 : ↓  || 
||  -5 : ←  ||  -5 : →  ||  -5 : →  ||  -5 : →  ||  -5 : →  ||  -4 : →  ||  -3 : →  ||  -2 : ↓  || 
||  -5 : ←  ||  -5 : →  ||  -5 : →  ||  -5 : →  ||  -5 : →  ||  -4 : →  ||  -3 : →  ||  -2 : ↓  || 
||  -5 : ←  ||  -5 : →  ||  -5 : →  ||  -5 : →  ||  -5 : →  ||  -4 : →  ||  -3 : →  ||  -2 : ↓  || 
||  -5 : ←  ||  -5 : →  ||  -5 : →  ||  -5 : →  ||  -5 : →  ||  -4 : →  ||  -3 : →  ||  -2 : ↓  || 
||  -5 : ←  ||  -5 : →  ||  -5 : →  ||  -5 : →  ||  -5 : →  ||  -4 : →  ||  -3 : →  ||  -2 : ↓  || 
-------------------------
iteration: 6

||  -6 : ←  ||  -6 : →  ||  -6 : →  ||  -6 : →  ||  -5 : →  ||  -4 : →  ||  -3 : →  ||  -2 : ↓  || 
||  -6 : ←  ||  -6 : →  ||  -6 : →  ||  -6 : →  ||  -5 : →  ||  -4 : →  ||  -3 : →  ||  -2 : ↓  || 
||  -6 : ←  ||  -6 : →  ||  -6 : →  ||  -6 : →  ||  -5 : →  ||  -4 : →  ||  -3 : →  ||  -2 : ↓  || 
||  -6 : ←  ||  -6 : →  ||  -6 : →  ||  -6 : →  ||  -5 : →  ||  -4 : →  ||  -3 : →  ||  -2 : ↓  || 
||  -6 : ←  ||  -6 : →  ||  -6 : →  ||  -6 : →  ||  -5 : →  ||  -4 : →  ||  -3 : →  ||  -2 : ↓  || 
||  -6 : ←  ||  -6 : →  ||  -6 : →  ||  -6 : →  ||  -5 : →  ||  -4 : →  ||  -3 : →  ||  -2 : ↓  || 
||  -6 : ←  ||  -6 : →  ||  -6 : →  ||  -6 : →  ||  -5 : →  ||  -4 : →  ||  -3 : →  ||  -2 : ↓  || 
||  -6 : ←  ||  -6 : →  ||  -6 : →  ||  -6 : →  ||  -5 : →  ||  -4 : →  ||  -3 : →  ||  -2 : ↓  || 
-------------------------
iteration: 7

||  -7 : ←  ||  -7 : →  ||  -7 : →  ||  -6 : →  ||  -5 : →  ||  -4 : →  ||  -3 : →  ||  -2 : ↓  || 
||  -7 : ←  ||  -7 : →  ||  -7 : →  ||  -6 : →  ||  -5 : →  ||  -4 : →  ||  -3 : →  ||  -2 : ↓  || 
||  -7 : ←  ||  -7 : →  ||  -7 : →  ||  -6 : →  ||  -5 : →  ||  -4 : →  ||  -3 : →  ||  -2 : ↓  || 
||  -7 : ←  ||  -7 : →  ||  -7 : →  ||  -6 : →  ||  -5 : →  ||  -4 : →  ||  -3 : →  ||  -2 : ↓  || 
||  -7 : ←  ||  -7 : →  ||  -7 : →  ||  -6 : →  ||  -5 : →  ||  -4 : →  ||  -3 : →  ||  -2 : ↓  || 
||  -7 : ←  ||  -7 : →  ||  -7 : →  ||  -6 : →  ||  -5 : →  ||  -4 : →  ||  -3 : →  ||  -2 : ↓  || 
||  -7 : ←  ||  -7 : →  ||  -7 : →  ||  -6 : →  ||  -5 : →  ||  -4 : →  ||  -3 : →  ||  -2 : ↓  || 
||  -7 : ←  ||  -7 : →  ||  -7 : →  ||  -6 : →  ||  -5 : →  ||  -4 : →  ||  -3 : →  ||  -2 : ↓  || 
-------------------------
iteration: 8

||  -8 : ←  ||  -8 : →  ||  -7 : →  ||  -6 : →  ||  -5 : →  ||  -4 : →  ||  -3 : →  ||  -2 : ↓  || 
||  -8 : ←  ||  -8 : →  ||  -7 : →  ||  -6 : →  ||  -5 : →  ||  -4 : →  ||  -3 : →  ||  -2 : ↓  || 
||  -8 : ←  ||  -8 : →  ||  -7 : →  ||  -6 : →  ||  -5 : →  ||  -4 : →  ||  -3 : →  ||  -2 : ↓  || 
||  -8 : ←  ||  -8 : →  ||  -7 : →  ||  -6 : →  ||  -5 : →  ||  -4 : →  ||  -3 : →  ||  -2 : ↓  || 
||  -8 : ←  ||  -8 : →  ||  -7 : →  ||  -6 : →  ||  -5 : →  ||  -4 : →  ||  -3 : →  ||  -2 : ↓  || 
||  -8 : ←  ||  -8 : →  ||  -7 : →  ||  -6 : →  ||  -5 : →  ||  -4 : →  ||  -3 : →  ||  -2 : ↓  || 
||  -8 : ←  ||  -8 : →  ||  -7 : →  ||  -6 : →  ||  -5 : →  ||  -4 : →  ||  -3 : →  ||  -2 : ↓  || 
||  -7 : →  ||  -8 : →  ||  -7 : →  ||  -6 : →  ||  -5 : →  ||  -4 : →  ||  -3 : →  ||  -2 : ↓  || 
-------------------------
iteration: 9

||  -9 : ←  ||  -8 : →  ||  -7 : →  ||  -6 : →  ||  -5 : →  ||  -4 : →  ||  -3 : →  ||  -2 : ↓  || 
||  -9 : ←  ||  -8 : →  ||  -7 : →  ||  -6 : →  ||  -5 : →  ||  -4 : →  ||  -3 : →  ||  -2 : ↓  || 
||  -9 : ←  ||  -8 : →  ||  -7 : →  ||  -6 : →  ||  -5 : →  ||  -4 : →  ||  -3 : →  ||  -2 : ↓  || 
||  -9 : ←  ||  -8 : →  ||  -7 : →  ||  -6 : →  ||  -5 : →  ||  -4 : →  ||  -3 : →  ||  -2 : ↓  || 
||  -9 : ←  ||  -8 : →  ||  -7 : →  ||  -6 : →  ||  -5 : →  ||  -4 : →  ||  -3 : →  ||  -2 : ↓  || 
||  -9 : ←  ||  -8 : →  ||  -7 : →  ||  -6 : →  ||  -5 : →  ||  -4 : →  ||  -3 : →  ||  -2 : ↓  || 
||  -8 : →  ||  -8 : →  ||  -7 : →  ||  -6 : →  ||  -5 : →  ||  -4 : →  ||  -3 : →  ||  -2 : ↓  || 
||  -7 : →  ||  -8 : →  ||  -7 : →  ||  -6 : →  ||  -5 : →  ||  -4 : →  ||  -3 : →  ||  -2 : ↓  || 
-------------------------
iteration: 10

||  -10 : ← ||  -7 : →  ||  -7 : →  ||  -6 : →  ||  -5 : →  ||  -4 : →  ||  -3 : →  ||  -2 : ↓  || 
||  -10 : ← ||  -7 : →  ||  -7 : →  ||  -6 : →  ||  -5 : →  ||  -4 : →  ||  -3 : →  ||  -2 : ↓  || 
||  -10 : ← ||  -7 : →  ||  -7 : →  ||  -6 : →  ||  -5 : →  ||  -4 : →  ||  -3 : →  ||  -2 : ↓  || 
||  -10 : ← ||  -7 : →  ||  -7 : →  ||  -6 : →  ||  -5 : →  ||  -4 : →  ||  -3 : →  ||  -2 : ↓  || 
||  -10 : ← ||  -7 : →  ||  -7 : →  ||  -6 : →  ||  -5 : →  ||  -4 : →  ||  -3 : →  ||  -2 : ↓  || 
||  -9 : →  ||  -8 : →  ||  -7 : →  ||  -6 : →  ||  -5 : →  ||  -4 : →  ||  -3 : →  ||  -2 : ↓  || 
||  -8 : →  ||  -8 : →  ||  -7 : →  ||  -6 : →  ||  -5 : →  ||  -4 : →  ||  -3 : →  ||  -2 : ↓  || 
||  -7 : →  ||  -8 : →  ||  -7 : →  ||  -6 : →  ||  -5 : →  ||  -4 : →  ||  -3 : →  ||  -2 : ↓  || 
-------------------------
iteration: 11

||  -11 : ← ||  -7 : →  ||  -7 : →  ||  -6 : →  ||  -5 : →  ||  -4 : →  ||  -3 : →  ||  -2 : ↓  || 
||  -11 : ← ||  -7 : →  ||  -7 : →  ||  -6 : →  ||  -5 : →  ||  -4 : →  ||  -3 : →  ||  -2 : ↓  || 
||  -11 : ← ||  -7 : →  ||  -7 : →  ||  -6 : →  ||  -5 : →  ||  -4 : →  ||  -3 : →  ||  -2 : ↓  || 
||  -11 : ← ||  -7 : →  ||  -7 : →  ||  -6 : →  ||  -5 : →  ||  -4 : →  ||  -3 : →  ||  -2 : ↓  || 
||  -10 : → ||  -7 : →  ||  -7 : →  ||  -6 : →  ||  -5 : →  ||  -4 : →  ||  -3 : →  ||  -2 : ↓  || 
||  -9 : →  ||  -8 : →  ||  -7 : →  ||  -6 : →  ||  -5 : →  ||  -4 : →  ||  -3 : →  ||  -2 : ↓  || 
||  -8 : →  ||  -8 : →  ||  -7 : →  ||  -6 : →  ||  -5 : →  ||  -4 : →  ||  -3 : →  ||  -2 : ↓  || 
||  -7 : →  ||  -8 : →  ||  -7 : →  ||  -6 : →  ||  -5 : →  ||  -4 : →  ||  -3 : →  ||  -2 : ↓  || 
-------------------------
iteration: 12

||  -12 : ← ||  -7 : →  ||  -7 : →  ||  -6 : →  ||  -5 : →  ||  -4 : →  ||  -3 : →  ||  -2 : ↓  || 
||  -12 : ← ||  -7 : →  ||  -7 : →  ||  -6 : →  ||  -5 : →  ||  -4 : →  ||  -3 : →  ||  -2 : ↓  || 
||  -12 : ← ||  -7 : →  ||  -7 : →  ||  -6 : →  ||  -5 : →  ||  -4 : →  ||  -3 : →  ||  -2 : ↓  || 
||  -11 : → ||  -7 : →  ||  -7 : →  ||  -6 : →  ||  -5 : →  ||  -4 : →  ||  -3 : →  ||  -2 : ↓  || 
||  -10 : → ||  -7 : →  ||  -7 : →  ||  -6 : →  ||  -5 : →  ||  -4 : →  ||  -3 : →  ||  -2 : ↓  || 
||  -9 : →  ||  -8 : →  ||  -7 : →  ||  -6 : →  ||  -5 : →  ||  -4 : →  ||  -3 : →  ||  -2 : ↓  || 
||  -8 : →  ||  -8 : →  ||  -7 : →  ||  -6 : →  ||  -5 : →  ||  -4 : →  ||  -3 : →  ||  -2 : ↓  || 
||  -7 : →  ||  -8 : →  ||  -7 : →  ||  -6 : →  ||  -5 : →  ||  -4 : →  ||  -3 : →  ||  -2 : ↓  || 
-------------------------
iteration: 13

||  -13 : ← ||  -7 : →  ||  -7 : →  ||  -6 : →  ||  -5 : →  ||  -4 : →  ||  -3 : →  ||  -2 : ↓  || 
||  -13 : ← ||  -7 : →  ||  -7 : →  ||  -6 : →  ||  -5 : →  ||  -4 : →  ||  -3 : →  ||  -2 : ↓  || 
||  -12 : → ||  -7 : →  ||  -7 : →  ||  -6 : →  ||  -5 : →  ||  -4 : →  ||  -3 : →  ||  -2 : ↓  || 
||  -11 : → ||  -7 : →  ||  -7 : →  ||  -6 : →  ||  -5 : →  ||  -4 : →  ||  -3 : →  ||  -2 : ↓  || 
||  -10 : → ||  -7 : →  ||  -7 : →  ||  -6 : →  ||  -5 : →  ||  -4 : →  ||  -3 : →  ||  -2 : ↓  || 
||  -9 : →  ||  -8 : →  ||  -7 : →  ||  -6 : →  ||  -5 : →  ||  -4 : →  ||  -3 : →  ||  -2 : ↓  || 
||  -8 : →  ||  -8 : →  ||  -7 : →  ||  -6 : →  ||  -5 : →  ||  -4 : →  ||  -3 : →  ||  -2 : ↓  || 
||  -7 : →  ||  -8 : →  ||  -7 : →  ||  -6 : →  ||  -5 : →  ||  -4 : →  ||  -3 : →  ||  -2 : ↓  || 
-------------------------
iteration: 14

||  -14 : ← ||  -7 : →  ||  -7 : →  ||  -6 : →  ||  -5 : →  ||  -4 : →  ||  -3 : →  ||  -2 : ↓  || 
||  -13 : → ||  -7 : →  ||  -7 : →  ||  -6 : →  ||  -5 : →  ||  -4 : →  ||  -3 : →  ||  -2 : ↓  || 
||  -12 : → ||  -7 : →  ||  -7 : →  ||  -6 : →  ||  -5 : →  ||  -4 : →  ||  -3 : →  ||  -2 : ↓  || 
||  -11 : → ||  -7 : →  ||  -7 : →  ||  -6 : →  ||  -5 : →  ||  -4 : →  ||  -3 : →  ||  -2 : ↓  || 
||  -10 : → ||  -7 : →  ||  -7 : →  ||  -6 : →  ||  -5 : →  ||  -4 : →  ||  -3 : →  ||  -2 : ↓  || 
||  -9 : →  ||  -8 : →  ||  -7 : →  ||  -6 : →  ||  -5 : →  ||  -4 : →  ||  -3 : →  ||  -2 : ↓  || 
||  -8 : →  ||  -8 : →  ||  -7 : →  ||  -6 : →  ||  -5 : →  ||  -4 : →  ||  -3 : →  ||  -2 : ↓  || 
||  -7 : →  ||  -8 : →  ||  -7 : →  ||  -6 : →  ||  -5 : →  ||  -4 : →  ||  -3 : →  ||  -2 : ↓  || 
-------------------------
iteration: 15

||  -14 : → ||  -7 : →  ||  -7 : →  ||  -6 : →  ||  -5 : →  ||  -4 : →  ||  -3 : →  ||  -2 : ↓  || 
||  -13 : → ||  -7 : →  ||  -7 : →  ||  -6 : →  ||  -5 : →  ||  -4 : →  ||  -3 : →  ||  -2 : ↓  || 
||  -12 : → ||  -7 : →  ||  -7 : →  ||  -6 : →  ||  -5 : →  ||  -4 : →  ||  -3 : →  ||  -2 : ↓  || 
||  -11 : → ||  -7 : →  ||  -7 : →  ||  -6 : →  ||  -5 : →  ||  -4 : →  ||  -3 : →  ||  -2 : ↓  || 
||  -10 : → ||  -7 : →  ||  -7 : →  ||  -6 : →  ||  -5 : →  ||  -4 : →  ||  -3 : →  ||  -2 : ↓  || 
||  -9 : →  ||  -8 : →  ||  -7 : →  ||  -6 : →  ||  -5 : →  ||  -4 : →  ||  -3 : →  ||  -2 : ↓  || 
||  -8 : →  ||  -8 : →  ||  -7 : →  ||  -6 : →  ||  -5 : →  ||  -4 : →  ||  -3 : →  ||  -2 : ↓  || 
||  -7 : →  ||  -8 : →  ||  -7 : →  ||  -6 : →  ||  -5 : →  ||  -4 : →  ||  -3 : →  ||  -2 : ↓  || 